0000000000000000000000000000000000000000
0101111110111101000001011111100000111110
0100000010100001111111010000100000010000
0111000010101111010000011110101111110010
0101111110101000011111010000101000010110
0100001000101001010101111111111111010010
0101101111101011110100000001001001010110
0111001010001010010100111111011101010010
0100001011111010010101101011010101011110
0001111010101010010101001010010101010010
1111001010101111110101101011010101011010
0101111110101000010100001001010101001111
0101010000101010110111111101110101011010
0100010111101010100100010101010101010010
0111110100001010101101010101010101111010
0100000101111010101001011101010100001110
0111110100001010101001000101011111100010
0100011111100011111011110101000001001010
0111110100111110101000011101111111111110
0000000000000000000000000000000000000000